~~~~~~~~~~~~~~~~~~~~~~~~~~~~~~~~~~~~~~~~~~~~~~~~~~~
~~~~~~~~~~~~~~~~~~~~~~~~~~~~~~~~~~~~~~~~~~~~~~~~~~~
~~~~~~~~~~~~~~~~~~~~~~~~~~~~~~~~~~~~~~~~~~~~~~~~~~~
~~~~~~~~~~~~~~~~~~~~~~~~~~~~~~~~~~~~~~~~~~~~~~~~~~~
~~~~~~~~~~~~~##########################~~~~~~~~~~~~
~~~~~~~~~~~~############################~~~~~~~~~~~
~~~~~~~~~~~##############################~~~~~~~~~~
~~~~~~~~~~~###############################~~~~~~~~~
~~~~~~~~~~#################################~~~~~~~~
~~~~~~~~~~#################################~~~~~~~~
~~~~~~~~~~~################################~~~~~~~~
~~~~~~~~~~~#################################~~~~~~~
~~~~~~~~~~##################################~~~~~~~
~~~~~~~~~~##################################~~~~~~~
~~~~~~~~~~###################################~~~~~~
~~~~~~~~~####################################~~~~~~
~~~~~~~~~###################################~~~~~~~
~~~~~~~~~~##################################~~~~~~~
~~~~~~~~~~~###############################~~~~~~~~~
~~~~~~~~~~~~~~~~~~~~~~~~~~~~~~~~~~~~~~~~~~~~~~~~~~~
~~~~~~~~~~~~~~~~~~~~~~~~~~~~~~~~~~~~~~~~~~~~~~~~~~~
~~~~~~~~~~~~~~~~~~~~~~~~~~~~~~~~~~~~~~~~~~~~~~~~~~~
~~~~~~~~~~~~~~~~~~~~~~~~~~~~~~~~~~~~~~~~~~~~~~~~~~~
~~~~~~~~~~~~~~~~~~~~~~~~~~~~~~~~~~~~~~~~~~~~~~~~~~~